Hallo.	Hello.	[sound:Firetongues-DE-EN-0001.mp3]	
Ich bin Max, und du?	I am Max, and you are?	[sound:Firetongues-DE-EN-0002.mp3]	
Ich heiße Anna.	My name is Anna. / I am called Anna.	[sound:Firetongues-DE-EN-0003.mp3]	
Es freut mich dich kennenzulernen.	Nice to meet you.	[sound:Firetongues-DE-EN-0004.mp3]	
Freut mich.	Nice to meet you. (short form)	[sound:Firetongues-DE-EN-0005.mp3]	
Du bist Lena, richtig?	You are Lena, right?	[sound:Firetongues-DE-EN-0006.mp3]	
Nein.	No.	[sound:Firetongues-DE-EN-0007.mp3]	
Entschuldigung.	Excuse me.	[sound:Firetongues-DE-EN-0008.mp3]	
Wie geht es dir?	How are you?	[sound:Firetongues-DE-EN-0009.mp3]	
Mir geht es gut, und dir?	I am fine. And you?	[sound:Firetongues-DE-EN-0010.mp3]	
Auch gut, danke.	I'm fine too, thanks.	[sound:Firetongues-DE-EN-0011.mp3]	
Studierst du auch Biologie?	Do you also study biology?	[sound:Firetongues-DE-EN-0012.mp3]	
Ja, genau.	Yes exactly.	[sound:Firetongues-DE-EN-0013.mp3]	
Ich bin im ersten Semester.	I am in the first semester.	[sound:Firetongues-DE-EN-0014.mp3]	
Ich auch.	Me too.	[sound:Firetongues-DE-EN-0015.mp3]	
Bist du neu in München?	Are you new to Munich?	[sound:Firetongues-DE-EN-0016.mp3]	
Ich komme aus Berlin.	I come from Berlin.	[sound:Firetongues-DE-EN-0017.mp3]	
Das ist weit weg.	That's far away.	[sound:Firetongues-DE-EN-0018.mp3]	
Warum studierst du nicht in Berlin?	Why don't you study in Berlin?	[sound:Firetongues-DE-EN-0019.mp3]	
Stadt	city	[sound:Firetongues-DE-EN-0020.mp3]	
Die Uni in München ist gut.	The University of Munich is good.	[sound:Firetongues-DE-EN-0021.mp3]	
Ja, stimmt.	Yes, that's right.	[sound:Firetongues-DE-EN-0022.mp3]	
Ich muss los. Tschüs!	I have to go. Bye!	[sound:Firetongues-DE-EN-0023.mp3]	
Woher kommst du?	Where are you from?	[sound:Firetongues-DE-EN-0024.mp3]	
Ich komme aus England.	I'm from England.	[sound:Firetongues-DE-EN-0025.mp3]	
Du kommst aus England?	You're from England?	[sound:Firetongues-DE-EN-0026.mp3]	
Woher genau?	Where (are you) from exactly?	[sound:Firetongues-DE-EN-0027.mp3]	
in der Nähe von London	near London	[sound:Firetongues-DE-EN-0028.mp3]	
Was machst du in Deutschland?	What are you doing in Germany?	[sound:Firetongues-DE-EN-0029.mp3]	
Ich lerne hier Deutsch.	I'm learning German here.	[sound:Firetongues-DE-EN-0030.mp3]	
Toll!	Great!	[sound:Firetongues-DE-EN-0031.mp3]	
Warum lernst du Deutsch?	Why are you learning German?	[sound:Firetongues-DE-EN-0032.mp3]	
Ich möchte in Deutschland studieren.	I want to study in Germany.	[sound:Firetongues-DE-EN-0033.mp3]	
Viel Erfolg!	I wish you success!	[sound:Firetongues-DE-EN-0034.mp3]	
Vielen Dank!	Thank you so much!	[sound:Firetongues-DE-EN-0035.mp3]	
Wie heißt du?	What's your name? / What are you called?	[sound:Firetongues-DE-EN-0036.mp3]	
Ich komme aus Spanien.	I'm from Spain.	[sound:Firetongues-DE-EN-0037.mp3]	
Sprichst du Spanisch?	Do you speak Spanish?	[sound:Firetongues-DE-EN-0038.mp3]	
Ich spreche ein bisschen Spanisch.	I speak a little Spanish.	[sound:Firetongues-DE-EN-0039.mp3]	
Du sprichst sehr gut Deutsch!	You speak German very well!	[sound:Firetongues-DE-EN-0040.mp3]	
Danke.	Thanks.	[sound:Firetongues-DE-EN-0041.mp3]	
Ich möchte in Deutschland arbeiten.	I want to work in Germany.	[sound:Firetongues-DE-EN-0042.mp3]	
Bist du Studentin?	Are you a student (female)?	[sound:Firetongues-DE-EN-0043.mp3]	
Bist du Student?	Are you student (male)?	[sound:Firetongues-DE-EN-0044.mp3]	
Ich studiere Biologie.	I study biology.	[sound:Firetongues-DE-EN-0045.mp3]	
Was machst du von Beruf?	What do you do for a living?	[sound:Firetongues-DE-EN-0046.mp3]	
Ich bin Programmierer.	I am a programmer.	[sound:Firetongues-DE-EN-0047.mp3]	
Schön dich kennenzulernen.	Pleasure to meet you.	[sound:Firetongues-DE-EN-0048.mp3]	
Bis zum nächsten Mal!	See you next time!	[sound:Firetongues-DE-EN-0049.mp3]	
Ich verstehe nicht.	I don't understand.	[sound:Firetongues-DE-EN-0050.mp3]	
Ich spreche kein Deutsch.	I don't speak German.	[sound:Firetongues-DE-EN-0051.mp3]	
Sprechen Sie Englisch?	Do you speak English? (fr.)	[sound:Firetongues-DE-EN-0052.mp3]	
Kannst du das nochmal sagen?	Can you say that again?	[sound:Firetongues-DE-EN-0053.mp3]	
Sprich bitte langsam.	Please talk slowly.	[sound:Firetongues-DE-EN-0054.mp3]	
Was heißt … auf Deutsch?	How do you say... in German?/<div>What is... called in German?</div>	[sound:Firetongues-DE-EN-0055.mp3]	
jetzt	now	[sound:Firetongues-DE-EN-0056.mp3]	
Gratulation.	Congratulations.	[sound:Firetongues-DE-EN-0057.mp3]	
Wie geht's?	How are you? (short form)	[sound:Firetongues-DE-EN-0058.mp3]	
Mir geht's gut, danke.	I'm fine, thanks.	[sound:Firetongues-DE-EN-0059.mp3]	
Wie gefällt dir München?	How do you like Munich?	[sound:Firetongues-DE-EN-0060.mp3]	
München ist sehr schön.	Munich is very nice.	[sound:Firetongues-DE-EN-0061.mp3]	
Jeder hier ist nett.	Everyone here is nice.	[sound:Firetongues-DE-EN-0062.mp3]	
Bist du auch neu hier?	Are you also new here?	[sound:Firetongues-DE-EN-0063.mp3]	
Oh, du bist von hier?	Oh, you're from here?	[sound:Firetongues-DE-EN-0064.mp3]	
Du trinkst bestimmt jeden Tag Bier.	You probably drink beer every day.	[sound:Firetongues-DE-EN-0065.mp3]	
Richtig.	Correct.	[sound:Firetongues-DE-EN-0066.mp3]	
Ich trinke Bier wie Wasser.	I drink beer like water.	[sound:Firetongues-DE-EN-0067.mp3]	
Wirklich?	Really? / Virkelig?	[sound:Firetongues-DE-EN-0068.mp3]	
Spaß, so schlimm bin ich nicht.	Just kidding, I'm not that bad.	[sound:Firetongues-DE-EN-0069.mp3]	
Aber ich liebe Bier.	But I love beer.	[sound:Firetongues-DE-EN-0070.mp3]	
Möchtest du zusammen ein Bier trinken gehen?	Would you like to have a beer together?	[sound:Firetongues-DE-EN-0071.mp3]	
Ich kenne dich noch nicht gut.	I don't know you well yet.	[sound:Firetongues-DE-EN-0072.mp3]	
Es ist zu früh für ein Date.	It is too early for a date.	[sound:Firetongues-DE-EN-0073.mp3]	
Nein, danke.	No thanks.	[sound:Firetongues-DE-EN-0074.mp3]	
Kein Problem.	No problem.	[sound:Firetongues-DE-EN-0075.mp3]	
Bis dann!	See you!	[sound:Firetongues-DE-EN-0076.mp3]	
Keine Ahnung.	No idea.	[sound:Firetongues-DE-EN-0077.mp3]	
es gibt	there are	[sound:Firetongues-DE-EN-0078.mp3]	
Montag, Dienstag, Mittwoch	Monday, Tuesday, Wednesday	[sound:Firetongues-DE-EN-0079.mp3]	
Donnerstag, Freitag, Samstag, Sonntag	Thursday, Friday, Saturday, Sunday	[sound:Firetongues-DE-EN-0080.mp3]	
am Dienstag	on Tuesday	[sound:Firetongues-DE-EN-0081.mp3]	
Das Wetter ist heute schön.	The weather is nice today.	[sound:Firetongues-DE-EN-0082.mp3]	
Es ist sehr warm.	It is very warm.	[sound:Firetongues-DE-EN-0083.mp3]	
Hast du Lust auf ein Eis?	Do you feel like having an ice cream?	[sound:Firetongues-DE-EN-0084.mp3]	
Wie ist das Wetter morgen?	What's the weather tomorrow?/<div>How is the weather tomorrow?</div>	[sound:Firetongues-DE-EN-0085.mp3]	
Es ist zu kalt für ein Eis.	It's too cold for an ice cream.	[sound:Firetongues-DE-EN-0086.mp3]	
Außerdem regnet es wahrscheinlich.	It will probably rain, too./<div>Also, it is probably raining.</div>	[sound:Firetongues-DE-EN-0087.mp3]	
Tut mir leid.	I'm sorry.	[sound:Firetongues-DE-EN-0088.mp3]	
Heute habe ich keine Zeit.	Today I don't have time.	[sound:Firetongues-DE-EN-0089.mp3]	
Ich gehe heute Nachmittag ins Sprachcafé.	I'm going to the language café this afternoon.	[sound:Firetongues-DE-EN-0093.mp3]	
Gleich beginnt es.	It starts in a moment./<div>It is about to begin.</div>	[sound:Firetongues-DE-EN-0094.mp3]	
Anna kommt aus Berlin.	Anna is from Berlin.	[sound:Firetongues-DE-EN-0095.mp3]	
Jetzt wohnt sie in München, weil sie dort Biologie studiert.	Now she lives in Munich because she studies biology there./<div>Now she lives in Munich while she studies biology there.</div>	[sound:Firetongues-DE-EN-0096.mp3]	
München gefällt ihr sehr gut.	She likes Munich very much.	[sound:Firetongues-DE-EN-0097.mp3]	
Sie geht gerne ins Sprachcafé.	She likes going to the language café.	[sound:Firetongues-DE-EN-0098.mp3]	
Dort spricht sie Deutsch, Englisch oder Spanisch.	There, she speaks German, English or Spanish.	[sound:Firetongues-DE-EN-0099.mp3]	
Max kommt aus München.	Max is from Munich./<div>Max comes from Munich.</div>	[sound:Firetongues-DE-EN-0100.mp3]	
Er liebt Bier.	He loves beer.	[sound:Firetongues-DE-EN-0101.mp3]	
Max möchte gerne eine Freundin haben.	Max would like to have a girlfriend.	[sound:Firetongues-DE-EN-0102.mp3]	
Anna ist sehr hübsch.	Anna is very pretty.	[sound:Firetongues-DE-EN-0103.mp3]	
Sie sagt nein.	She says no.	[sound:Firetongues-DE-EN-0106.mp3]	
Was machst du gerne in deiner Freizeit?	What do you like to do in your free time?	[sound:Firetongues-DE-EN-0107.mp3]	
Ich höre gern Musik.	I like to listen to music.	[sound:Firetongues-DE-EN-0108.mp3]	
Wer ist dein Lieblingssänger? Wer ist dein Lieblingsschauspieler?	Who is your favorite singer? Who is your favorite actor?	[sound:Firetongues-DE-EN-0109.mp3]	
Ich weiß nicht genau.	I'm not sure. (I don't know for sure.)/<br>I don't know exactly.	[sound:Firetongues-DE-EN-0110.mp3]	
Mein Lieblingsfilm ist Star Wars.	My favorite movie is Star Wars.	[sound:Firetongues-DE-EN-0111.mp3]	
Was ist dein Lieblingsbuch?	What's your favorite book?	[sound:Firetongues-DE-EN-0112.mp3]	
Ich lese nur selten.	I rarely read.	[sound:Firetongues-DE-EN-0113.mp3]	
Was ist dein Lieblingsessen?	What's your favorite food?	[sound:Firetongues-DE-EN-0114.mp3]	
Mein Lieblingstier ist die Kuh.	My favorite animal is the cow.	[sound:Firetongues-DE-EN-0115.mp3]	
Und selbst?	What about you? (lit. And yourself?)	[sound:Firetongues-DE-EN-0116.mp3]	
Ich habe eine Frage.	I have a question.	[sound:Firetongues-DE-EN-0117.mp3]	
Du musst.	You must.	[sound:Firetongues-DE-EN-0119.mp3]	
Das ist sehr schwer für mich.	This is very hard for me.	[sound:Firetongues-DE-EN-0122.mp3]	
Woher weißt du das?	How do you know that?	[sound:Firetongues-DE-EN-0124.mp3]	
Das hoffe ich.	I hope so.	[sound:Firetongues-DE-EN-0129.mp3]	
Ich bin mir sicher.	I am sure.	[sound:Firetongues-DE-EN-0130.mp3]	
Mit der Zeit kommt das automatisch.	Over time, it'll come automatically./<br>With time it comes automatically.	[sound:Firetongues-DE-EN-0132.mp3]	
Der Ball ist klein.	The ball is small.	[sound:Firetongues-DE-EN-0133.mp3]	
Der Mann hat Geld.	The man has money.	[sound:Firetongues-DE-EN-0134.mp3]	
Die Stadt ist schön.	The city is beautiful.	[sound:Firetongues-DE-EN-0135.mp3]	
Die Schule ist weit weg.	The school is far away.	[sound:Firetongues-DE-EN-0136.mp3]	
Das Kind lernt Englisch.	The child learns English.	[sound:Firetongues-DE-EN-0137.mp3]	
Das Bier ist schlecht.	The beer is bad.	[sound:Firetongues-DE-EN-0138.mp3]	
Ein Ball ist meistens klein.	A ball is usually small.	[sound:Firetongues-DE-EN-0139.mp3]	
Max ist ein Mann.	Max is a man.	[sound:Firetongues-DE-EN-0140.mp3]	
Anna ist eine Frau.	Anna is a woman.	[sound:Firetongues-DE-EN-0141.mp3]	
München ist eine Stadt.	Munich is a city.	[sound:Firetongues-DE-EN-0142.mp3]	
Annas Bruder ist noch ein Kind.	Anna's brother is still a child.	[sound:Firetongues-DE-EN-0143.mp3]	
Ich trinke ein Bier.	I drink a beer.	[sound:Firetongues-DE-EN-0144.mp3]	
Gehst du oft ins Sprachcafé?	Do you often go to the language café?	[sound:Firetongues-DE-EN-0145.mp3]	
Ich gehe jede Woche dorthin.	I go there every week.	[sound:Firetongues-DE-EN-0146.mp3]	
Wie viele Leute gehen ins Sprachcafé?	How many people go to the language café?	[sound:Firetongues-DE-EN-0147.mp3]	
Das ist unterschiedlich.	"It depends (lit. ""that's different"")."	[sound:Firetongues-DE-EN-0148.mp3]	
Manchmal sind dort zehn Leute, manchmal zwanzig.	Sometimes there are ten people, sometimes twenty.	[sound:Firetongues-DE-EN-0149.mp3]	
Und das sind (sind das?) vor allem Ausländer oder Deutsche?	And these are mainly foreigners or German?	[sound:Firetongues-DE-EN-0150.mp3]	
Die Deutschen üben Englisch oder andere Fremdsprachen.	The Germans practice English or other foreign languages.	[sound:Firetongues-DE-EN-0152.mp3]	
Die Ausländer üben Deutsch.	The foreigners practice German.	[sound:Firetongues-DE-EN-0153.mp3]	
Welche Sprachen übst du dort?	Which languages do you practice there?	[sound:Firetongues-DE-EN-0154.mp3]	
Sprechen die Ausländer gut Deutsch?	Do the foreigners speak German well?	[sound:Firetongues-DE-EN-0158.mp3]	
Alle haben eine gute Motivation, Deutsch zu lernen.	Everyone has a good motivation to learn German.	[sound:Firetongues-DE-EN-0159.mp3]	
Sarah möchte in Deutschland studieren.	Sarah wants to study in Germany.	[sound:Firetongues-DE-EN-0160.mp3]	
Georg möchte hier arbeiten.	George wants to work here.	[sound:Firetongues-DE-EN-0161.mp3]	
Sie wollen unbedingt Deutsch lernen.	They absolutely want to learn German.	[sound:Firetongues-DE-EN-0162.mp3]	
Weil sie viel Deutsch üben, sprechen sie gut.	Since they practice German a lot, they speak well.	[sound:Firetongues-DE-EN-0163.mp3]	
Woher kommen Sarah und Georg?	Where are Sarah and Georg from?	[sound:Firetongues-DE-EN-0164.mp3]	
Alles klar.	All right.	[sound:Firetongues-DE-EN-0165.mp3]	
Das klingt interessant.	That sounds interesting.	[sound:Firetongues-DE-EN-0166.mp3]	
Kann ich nächstes Mal mitkommen?	Can I come with next time?	[sound:Firetongues-DE-EN-0167.mp3]	
Ja, warum nicht.	Yes, why not.	[sound:Firetongues-DE-EN-0168.mp3]	
Morgen ist das nächste Mal.	Tomorrow's the next time.	[sound:Firetongues-DE-EN-0169.mp3]	
Der Student lernt.	The student learns.	[sound:Firetongues-DE-EN-0170.mp3]	
Die Studenten lernen.	The students learn.	[sound:Firetongues-DE-EN-0171.mp3]	
Die Unis sind gut.	The universities are good.	[sound:Firetongues-DE-EN-0172.mp3]	
Die Schule ist groß.	The school is big.	[sound:Firetongues-DE-EN-0173.mp3]	
Schulen sind groß.	Schools are big.	[sound:Firetongues-DE-EN-0174.mp3]	
Die Biere sind schlecht.	The beers are bad.	[sound:Firetongues-DE-EN-0175.mp3]	
Das Kind spielt Ball.	The child plays ball.	[sound:Firetongues-DE-EN-0176.mp3]	
Kinder müssen viel spielen, um zu lernen.	Children need to play a lot to learn.	[sound:Firetongues-DE-EN-0177.mp3]	
Ein Mann muss stark sein.	A man must be strong.	[sound:Firetongues-DE-EN-0178.mp3]	
Männer müssen stark sein.	Men must be strong.	[sound:Firetongues-DE-EN-0179.mp3]	
Gehen wir heute ins Sprachcafé?	Are we going to the language café today?	[sound:Firetongues-DE-EN-0180.mp3]	
Ja, es ist heute Nachmittag um fünf.	Yes, it's this afternoon at five.	[sound:Firetongues-DE-EN-0181.mp3]	
Wie kommen wir dorthin?	How do we get there?	[sound:Firetongues-DE-EN-0182.mp3]	
Wir können laufen.	We can walk.	[sound:Firetongues-DE-EN-0183.mp3]	
Es sind zu Fuß nur fünfzehn Minuten.	It's only fifteen minutes by foot.	[sound:Firetongues-DE-EN-0184.mp3]	
Ich bin schon gespannt.	I'm curious already.	[sound:Firetongues-DE-EN-0185.mp3]	
Ist es wichtig pünktlich zu sein?	Is it important to be punctual?	[sound:Firetongues-DE-EN-0186.mp3]	
Um fünf sind erst wenige Leute dort.	At five there are only a few people there.	[sound:Firetongues-DE-EN-0187.mp3]	
Es reicht, wenn wir um fünf losgehen.	It will be enough if we leave at five.	[sound:Firetongues-DE-EN-0188.mp3]	
Treffen wir uns vor der Bibliothek?	Do we meet in front of the library?	[sound:Firetongues-DE-EN-0189.mp3]	
Seid ihr zusammen?	"Are you a couple? (lit. ""together"")"	[sound:Firetongues-DE-EN-0192.mp3]	
Wir sind nur Freunde.	We are just friends.	[sound:Firetongues-DE-EN-0193.mp3]	
Ach so.	I see.	[sound:Firetongues-DE-EN-0194.mp3]	
Kennt ihr euch schon lange?	Have you known each other for a long time?	[sound:Firetongues-DE-EN-0195.mp3]	
Woher kennt ihr euch?	How do you know each other?	[sound:Firetongues-DE-EN-0196.mp3]	
Wir kennen uns von der Uni.	We know each other from university.	[sound:Firetongues-DE-EN-0197.mp3]	
Wir sind Kommilitonen.	We are fellow students.	[sound:Firetongues-DE-EN-0198.mp3]	
Was heißt das?	What does that mean?	[sound:Firetongues-DE-EN-0199.mp3]	
Wenn Leute zusammen studieren, sind sie Kommilitonen.	When people study together, they are fellow students.	[sound:Firetongues-DE-EN-0200.mp3]	
Wir studieren beide Biologie.	We both study biology.	[sound:Firetongues-DE-EN-0201.mp3]	
Habt ihr viele Kurse zusammen?	Do you have many courses together?	[sound:Firetongues-DE-EN-0202.mp3]	
Wir sind beide im ersten Semester.	We are both in our first semester.	[sound:Firetongues-DE-EN-0203.mp3]	
Wie findet ihr euer Studium?	How do you (pl.) like your studies?/<br>How do you (pl.) find your studies?	[sound:Firetongues-DE-EN-0204.mp3]	
Bis jetzt sehr gut.	Very well so far.	[sound:Firetongues-DE-EN-0205.mp3]	
Wir haben tolle Professoren.	We have great professors.	[sound:Firetongues-DE-EN-0206.mp3]	
Ihr seid gute Studenten.	You are good students.	[sound:Firetongues-DE-EN-0207.mp3]	
Wir sind vor allem gute Biertrinker.	Above all, we are good beer drinkers./<br>We are especially good beer drinkers.	[sound:Firetongues-DE-EN-0208.mp3]	
Na ja, ich zumindest.	Well, at least I am.	[sound:Firetongues-DE-EN-0209.mp3]	
Guten Tag.	Hello. (polite)/<br>Good afternoon.	[sound:Firetongues-DE-EN-0210.mp3]	
Mein Name ist Georg López.	My name is George Lopez.	[sound:Firetongues-DE-EN-0211.mp3]	
Wie heißen Sie?	What's your name? / What are your called? (fr.)	[sound:Firetongues-DE-EN-0212.mp3]	
Es freut mich Sie kennenzulernen, Herr Müller.	Nice to meet you, Mr. Müller.	[sound:Firetongues-DE-EN-0213.mp3]	
Sind Sie der neue Praktikant?	Are you the new intern?	[sound:Firetongues-DE-EN-0214.mp3]	
Ich mache für drei Monate ein Praktikum bei Ihnen.	"I'm doing an internship at your company (lit. ""at you"") for three months./<br>I'm doing an internship with you for three months."	[sound:Firetongues-DE-EN-0215.mp3]	
Herzlich willkommen.	A warm welcome.	[sound:Firetongues-DE-EN-0216.mp3]	
Danke schön.	Thank you very much.	[sound:Firetongues-DE-EN-0217.mp3]	
Woher kommen Sie?	Where are you from? (fr.)	[sound:Firetongues-DE-EN-0218.mp3]	
Sie kommen aus Spanien, oder?	You're from Spain, right?/<br>You come from Spain, or? (fr.)	[sound:Firetongues-DE-EN-0219.mp3]	
Ich lebe seit sechs Monaten in Deutschland.	I've been living in Germany for six months.	[sound:Firetongues-DE-EN-0220.mp3]	
Entschuldigen Sie.	Excuse me. (fr.)	[sound:Firetongues-DE-EN-0221.mp3]	
Der Chef möchte, dass Sie in sein Büro kommen.	The boss wants you (fr.) to come to his office.	[sound:Firetongues-DE-EN-0222.mp3]	
Wie geht es Ihnen?	How are you? (fr.)	[sound:Firetongues-DE-EN-0226.mp3]	
Sehr gut, und Ihnen?	Very good, and you? (fr.)	[sound:Firetongues-DE-EN-0227.mp3]	
Wissen Sie, wo der Chef ist?	Do you (fr.) know where the boss is?	[sound:Firetongues-DE-EN-0230.mp3]	
Er hat gerade einen Termin.	He has an appointment right now.	[sound:Firetongues-DE-EN-0231.mp3]	
Er kommt in circa einer Stunde wieder.	He'll be here again in about an hour./<br>He's coming in about an hour.	[sound:Firetongues-DE-EN-0232.mp3]	
Sagen Sie ihm bitte, dass ich ihn suche.	Please tell him that I'm looking for him.	[sound:Firetongues-DE-EN-0233.mp3]	
natürlich	of course/<br>naturally	[sound:Firetongues-DE-EN-0235.mp3]	
In Ordnung.	All right.	[sound:Firetongues-DE-EN-0236.mp3]	
Was ist los?	What’s going on (surprised)?	[sound:Firetongues-DE-EN-0237.mp3]	
Das wird schon.	It will be alright.	[sound:Firetongues-DE-EN-0238.mp3]	
Ist mir egal.	I don't care.	[sound:Firetongues-DE-EN-0240.mp3]	
Wie sieht's aus?	How are things?	[sound:Firetongues-DE-EN-0241.mp3]	
Wie sieht es morgen aus?	How about tomorrow?/<br>(How does tomorrow look?)	[sound:Firetongues-DE-EN-0242.mp3]	
Das dauert ewig.	That takes forever.	[sound:Firetongues-DE-EN-0243.mp3]	
Wie hat dir gestern das Sprachcafé gefallen?	How did you like the language café yesterday?	[sound:Firetongues-DE-EN-0244.mp3]	
Wie hat es dir gefallen?	How did you like it?	[sound:Firetongues-DE-EN-0245.mp3]	
Ich habe viele nette Leute kennengelernt.	I have met many nice people	[sound:Firetongues-DE-EN-0246.mp3]	
Ich habe ein bisschen Englisch geübt.	I have practiced a bit of English.	[sound:Firetongues-DE-EN-0247.mp3]	
Das habe ich gemerkt.	I noticed./<br>I have noticed that.	[sound:Firetongues-DE-EN-0249.mp3]	
Wir haben ihr gesagt, dass das nicht stimmt.	We have told her that that's not true.	[sound:Firetongues-DE-EN-0250.mp3]	
Das heißt, du möchtest nächstes Mal auch mitkommen?	That means you want to come next time too?	[sound:Firetongues-DE-EN-0252.mp3]	
Ja, gerne.	Yes, I’d like to.	[sound:Firetongues-DE-EN-0253.mp3]	
Wir haben viel Spaß gehabt und viel gelacht, oder?	We had lots of fun and laughed a lot, right?	[sound:Firetongues-DE-EN-0254.mp3]	
Ich glaube, du hast mehr gelacht als ich.	I think you laughed more than I did.	[sound:Firetongues-DE-EN-0255.mp3]	
Ich finde es toll, dass alle Ausländer versucht haben, Deutsch zu sprechen.	I think it's great that all foreigners have tried to speak German./<br>I find it great that all foreigners have tried to speak German.	[sound:Firetongues-DE-EN-0258.mp3]	
Obwohl manche noch Anfänger sind.	Although some are still beginners.	[sound:Firetongues-DE-EN-0259.mp3]	
Sie haben wirklich gut Deutsch gesprochen.	They spoke German really well./<br>They have spoken really good German.	[sound:Firetongues-DE-EN-0260.mp3]	
Es ist sehr wichtig, dass man viel spricht, wenn man eine Sprache lernt.	It’s very important that one speaks a lot when one learns a language	[sound:Firetongues-DE-EN-0261.mp3]	
Ich sollte auch mehr Spanisch sprechen.	I should speak more Spanish.	[sound:Firetongues-DE-EN-0262.mp3]	
Gestern habe ich nur Deutsch und Englisch gesprochen.	Yesterday I spoke only German and English.	[sound:Firetongues-DE-EN-0263.mp3]	
Ich weiß, was du meinst.	I know what you mean.	[sound:Firetongues-DE-EN-0264.mp3]	
Ich habe auch kein Französisch gesprochen.	I have also spoken no French.	[sound:Firetongues-DE-EN-0265.mp3]	
Ich habe schon alles vergessen, was ich in der Schule gelernt habe.	I've forgotten everything I've learned at school./<br>I have already forgotten everything that I have learned in school.	[sound:Firetongues-DE-EN-0266.mp3]	
Dein Französisch ist bestimmt nicht so schlecht.	Your French is certainly not so bad.	[sound:Firetongues-DE-EN-0267.mp3]	
Wie lange hast du Französisch gelernt?	How long have you learned French?	[sound:Firetongues-DE-EN-0268.mp3]	
Unsere Lehrerin hat keinen guten Unterricht gemacht.	Our teacher (fem.) didn't do good classes.	[sound:Firetongues-DE-EN-0270.mp3]	
Du versuchst Französisch zu sprechen.	You try to speak French.	[sound:Firetongues-DE-EN-0271.mp3]	
Ich versuche Spanisch zu sprechen.	I try to speak Spanish.	[sound:Firetongues-DE-EN-0272.mp3]	
Das machen wir.	Let's do that.	[sound:Firetongues-DE-EN-0273.mp3]	
Sie haben getrunken.	They drank.	[sound:Firetongues-DE-EN-0274.mp3]	
Wir haben gesprochen.	We have spoken.	[sound:Firetongues-DE-EN-0275.mp3]	
Was haben Sie am Wochenende gemacht?	What did you do on the weekend? (fr.)	[sound:Firetongues-DE-EN-0276.mp3]	
Ich bin nach Heidelberg gefahren.	I went to Heidelberg.	[sound:Firetongues-DE-EN-0277.mp3]	
Ich habe dort einen Freund besucht.	I visited a friend there.	[sound:Firetongues-DE-EN-0278.mp3]	
Wie lange sind Sie dort gewesen?	How long have you been there? (fr., sg.)	[sound:Firetongues-DE-EN-0279.mp3]	
Ich bin zwei Tage dort gewesen.	I've been there for two days.	[sound:Firetongues-DE-EN-0280.mp3]	
Am Samstagmorgen bin ich ankommen.	On Saturday morning I arrived.	[sound:Firetongues-DE-EN-0281.mp3]	
Am Sonntagabend bin ich wieder heimgefahren.	On Sunday evening I drove home again.	[sound:Firetongues-DE-EN-0282.mp3]	
Sind Sie mit dem Auto gefahren?	Did you go by car? (fr., sg.)	[sound:Firetongues-DE-EN-0283.mp3]	
Ich bin mit dem Zug gefahren.	I went by train.	[sound:Firetongues-DE-EN-0284.mp3]	
Man braucht circa vier Stunden.	It takes about four hours./<br>One spends about four hours.	[sound:Firetongues-DE-EN-0285.mp3]	
Wie hat Ihnen Heidelberg gefallen?	How did you like Heidelberg? (fr., sg.)	[sound:Firetongues-DE-EN-0286.mp3]	
Heidelberg ist eine sehr schöne Stadt.	Heidelberg is a very beautiful city.	[sound:Firetongues-DE-EN-0287.mp3]	
Wir sind zusammen durch die Altstadt gelaufen.	We walked through the old town together.	[sound:Firetongues-DE-EN-0288.mp3]	
Haben Sie auch das Schloss gesehen?	Have you also seen the castle? (fr., sg.)	[sound:Firetongues-DE-EN-0290.mp3]	
Wir sind als erstes zum Schloss gegangen.	We went to the castle first.	[sound:Firetongues-DE-EN-0291.mp3]	
Das habe ich ganz vergessen.	I had completely forgotten that.	[sound:Firetongues-DE-EN-0292.mp3]	
Es war ein schönes Wochenende.	It was a nice weekend.	[sound:Firetongues-DE-EN-0295.mp3]	
Es war anstrengend.	It was exhausting.	[sound:Firetongues-DE-EN-0296.mp3]	
Ich bin heute Morgen um sechs Uhr aufgestanden.	I got up at six o'clock this morning.	[sound:Firetongues-DE-EN-0297.mp3]	
Der dicke Mann geht einkaufen.	The fat man goes shopping.	[sound:Firetongues-DE-EN-0299.mp3]	
Herr Müller ist ein dicker Mann.	Mr. Müller is a fat man.	[sound:Firetongues-DE-EN-0300.mp3]	
Anna ist eine junge Frau.	Anna is a young woman.	[sound:Firetongues-DE-EN-0301.mp3]	
Die junge Frau liest ein Buch.	The young woman is reading a book.	[sound:Firetongues-DE-EN-0302.mp3]	
Das ist ein altes Haus.	This is an old house.	[sound:Firetongues-DE-EN-0303.mp3]	
Das alte Haus hat viel Charme.	The old house has a lot of charm.	[sound:Firetongues-DE-EN-0304.mp3]	
Schwache Menschen haben keinen Erfolg.	Weak people do not have success.	[sound:Firetongues-DE-EN-0305.mp3]	
Die freundlichen Leute lachen.	The friendly people laugh.	[sound:Firetongues-DE-EN-0306.mp3]	
Wie war dein Tag?	How was your day?	[sound:Firetongues-DE-EN-0307.mp3]	
Wir hatten frei.	"We had a day off. (""We had free."")"	[sound:Firetongues-DE-EN-0308.mp3]	
Wir mussten nicht in die Sprachschule gehen, weil Feiertag war.	We did not have to go to language school because it was a holiday.	[sound:Firetongues-DE-EN-0309.mp3]	
Wir konnten machen, was wir wollten.	We could do whatever we wanted./<br>We could do what we wanted.	[sound:Firetongues-DE-EN-0310.mp3]	
Was hast du gemacht?	What did you do?	[sound:Firetongues-DE-EN-0311.mp3]	
Wir wussten erst nicht, wie wir den Tag am besten nutzen konnten.	At first, we didn't know how we could best use the day.<br>We did not know at first how we could best use the day.	[sound:Firetongues-DE-EN-0313.mp3]	
Dann dachten wir: Wieso nicht wandern gehen?	Then we thought: Why not go hiking?	[sound:Firetongues-DE-EN-0314.mp3]	
Also haben wir unsere Sachen gepackt und sind losgegangen.	So we packed our stuff and went.	[sound:Firetongues-DE-EN-0315.mp3]	
Wo seid ihr gewandert?	Where did you hike? (pl.)	[sound:Firetongues-DE-EN-0316.mp3]	
Wie lange seid ihr gewandert?	How long did you hike?	[sound:Firetongues-DE-EN-0319.mp3]	
Ich glaube, es waren insgesamt fünf Stunden.	I think it was five hours in total.	[sound:Firetongues-DE-EN-0320.mp3]	
Wie fandest du es?	How did you like it?/<br>How did you find it? (inf., sg.)	[sound:Firetongues-DE-EN-0321.mp3]	
Ich fand es toll.	I found it great.	[sound:Firetongues-DE-EN-0322.mp3]	
Ich wusste nicht, dass Wandern so viel Spaß macht.	I didn't know that hiking was so much fun.	[sound:Firetongues-DE-EN-0323.mp3]	
Schön, dass ihr Spaß hattet.	It's nice that you had fun.	[sound:Firetongues-DE-EN-0324.mp3]	
Es ging.	It was okay.	[sound:Firetongues-DE-EN-0325.mp3]	
nichts Besonderes	nothing special	[sound:Firetongues-DE-EN-0326.mp3]	
Ich musste viel für die Uni machen.	I had to do a lot for university.	[sound:Firetongues-DE-EN-0327.mp3]	
Ich wusste nicht, was ich zu Mittag essen sollte.	I did not know what to eat for lunch.	[sound:Firetongues-DE-EN-0328.mp3]	
Also habe ich einfach Nudeln gemacht.	So I just made noodles.	[sound:Firetongues-DE-EN-0329.mp3]	
Normalerweise koche ich gerne.	Usually, I like to cook.	[sound:Firetongues-DE-EN-0331.mp3]	
Was hast du am Nachmittag gemacht?	What did you do in the afternoon?	[sound:Firetongues-DE-EN-0333.mp3]	
Eigentlich wollte ich mit einer Freundin ins Kino gehen.	Actually, I wanted to go to the movies with a friend (fem).	[sound:Firetongues-DE-EN-0334.mp3]	
Sie hat abgesagt, weil sie krank ist.	She canceled because she is sick.	[sound:Firetongues-DE-EN-0335.mp3]	
Also habe ich alleine einen Film auf Netflix geschaut.	So I watched a movie on Netflix alone.	[sound:Firetongues-DE-EN-0336.mp3]	
Was für einen Film?	What kind of movie?	[sound:Firetongues-DE-EN-0337.mp3]	
Es war ein Film aus Mexiko.	It was a movie from Mexico.	[sound:Firetongues-DE-EN-0338.mp3]	
Ich wollte mein Spanisch verbessern.	I wanted to improve my Spanish.	[sound:Firetongues-DE-EN-0339.mp3]	
Kannst du so gut Spanisch, dass du Filme auf Spanisch verstehst?	Can you Spanish so well that you understand movies in Spanish?	[sound:Firetongues-DE-EN-0340.mp3]	
Ich musste den Film mit Untertiteln schauen.	I had to watch the film with subtitles.	[sound:Firetongues-DE-EN-0341.mp3]	
Wie fandest du den Film?	How did you find the movie?	[sound:Firetongues-DE-EN-0342.mp3]	
Es war etwas langweilig.	It was a bit boring.	[sound:Firetongues-DE-EN-0343.mp3]	
Es ist nicht viel passiert.	Not much happened.	[sound:Firetongues-DE-EN-0344.mp3]	
Er kennt sie.	He knows her.	[sound:Firetongues-DE-EN-0348.mp3]	
Sie kennt ihn.	She knows him.	[sound:Firetongues-DE-EN-0349.mp3]	
Der kleine Junge fragt den Studenten.	The little boy asks the student.	[sound:Firetongues-DE-EN-0350.mp3]	
Der Student fragt den kleinen Jungen.	The student asks the little boy.	[sound:Firetongues-DE-EN-0351.mp3]	
Der Italiener mag den Deutschen.	The Italian likes the German.	[sound:Firetongues-DE-EN-0352.mp3]	
Der Deutsche mag den Italiener.	The German likes the Italian.	[sound:Firetongues-DE-EN-0353.mp3]	
Der Junge hasst die Schule.	The boy hates school.	[sound:Firetongues-DE-EN-0354.mp3]	
Sie hat einen sympathischen Mann getroffen.	She met a sympathetic/likeable man.	[sound:Firetongues-DE-EN-0355.mp3]	
Das Mädchen hat eine neue Tasche.	The girl has a new bag.	[sound:Firetongues-DE-EN-0356.mp3]	
Max trinkt ein großes Bier.	Max is drinking a big beer.	[sound:Firetongues-DE-EN-0357.mp3]	
Ohne den Menschen hat die Erde keine Probleme.	Without humans, the earth has no problems.	[sound:Firetongues-DE-EN-0358.mp3]	
Das Kind geht jeden Tag in die Schule.	The child goes to school every day.	[sound:Firetongues-DE-EN-0359.mp3]	
Wir müssen diese Übung als Hausaufgabe machen.	We have to do this exercise for homework.	[sound:Firetongues-DE-EN-0362.mp3]	
Ich verstehe nicht, was dieser Satz bedeutet.	I do not understand what this phrase means.	[sound:Firetongues-DE-EN-0363.mp3]	
Kannst du das bitte übersetzen?	Can you please translate this?	[sound:Firetongues-DE-EN-0364.mp3]	
Warst du schon einmal in Amerika?	Have you ever been to America?	[sound:Firetongues-DE-EN-0365.mp3]	
Ich war noch nie in Amerika.	I have never been to America.	[sound:Firetongues-DE-EN-0366.mp3]	
Ich reise gerne.	I like to travel.	[sound:Firetongues-DE-EN-0367.mp3]	
Es ist nicht gerade billig, nach Amerika zu fliegen.	It is not quite cheap to fly to America.	[sound:Firetongues-DE-EN-0368.mp3]	
Du hast recht.	You're right.	[sound:Firetongues-DE-EN-0369.mp3]	
Du musst auf diese Frage antworten.	You have to answer this question.	[sound:Firetongues-DE-EN-0370.mp3]	
Hast du mir etwas mitgebracht?	Did you bring me something?	[sound:Firetongues-DE-EN-0387.mp3]	
Anna hat Ferien.	Anna is on vacation.	[sound:Firetongues-DE-EN-0388.mp3]	
Sie ist nach Hause gefahren.	She went home.	[sound:Firetongues-DE-EN-0389.mp3]	
Ihre Eltern sind im Moment auf Arbeit.	Her parents are at work right now. /<br>Her parents are at the moment at work.	[sound:Firetongues-DE-EN-0390.mp3]	
Sie sitzt mit ihrem kleinen Bruder im Garten.	She is sitting with her little brother in the garden.	[sound:Firetongues-DE-EN-0391.mp3]	
Sie erzählt ihm von München.	She tells him about Munich.	[sound:Firetongues-DE-EN-0392.mp3]	
Meine Wohnung ist nicht weit von der Uni.	My apartment is not far from university.	[sound:Firetongues-DE-EN-0393.mp3]	
Mit der Straßenbahn bin ich in zehn Minuten dort.	By tram, I am there in ten minutes.	[sound:Firetongues-DE-EN-0394.mp3]	
Wenn ich sie verpasse, kommt die nächste in wenigen Minuten.	If I miss it, the next one comes in a few minutes.	[sound:Firetongues-DE-EN-0395.mp3]	
Wie ist es, alleine zu wohnen?	What is it like to live alone?	[sound:Firetongues-DE-EN-0396.mp3]	
Vermisst du mich nicht?	Don't you miss me?	[sound:Firetongues-DE-EN-0397.mp3]	
Natürlich vermisse ich euch.	Of course I miss you (pl.).	[sound:Firetongues-DE-EN-0399.mp3]	
Es hat Vorteile, alleine zu wohnen.	Living alone also has benefits.	[sound:Firetongues-DE-EN-0400.mp3]	
Ich kann mich besser auf das Lernen konzentrieren.	I can better concentrate on studying.	[sound:Firetongues-DE-EN-0401.mp3]	
Ich kann morgens ins Bad, wann ich will.	In the morning, I can use the bathroom when I want.	[sound:Firetongues-DE-EN-0402.mp3]	
Trotzdem war es eine gute Idee auszuziehen.	Still, it was a good idea to move out.	[sound:Firetongues-DE-EN-0404.mp3]	
Jetzt lebe ich mein eigenes Leben.	Now I'm living my own life.	[sound:Firetongues-DE-EN-0405.mp3]	
Das ist doch blöd.	That is just stupid.	[sound:Firetongues-DE-EN-0406.mp3]	
Ich möchte lieber, dass du (hier bleibst?) hierbleibst.	I'd prefer you staying here./<br>I would rather you stay here.	[sound:Firetongues-DE-EN-0407.mp3]	
Das geht leider nicht.	Unfortunately, that is not possible.	[sound:Firetongues-DE-EN-0408.mp3]	
Ich habe mich entschieden, in einer anderen Stadt zu studieren.	I decided to study in another city.	[sound:Firetongues-DE-EN-0409.mp3]	
Ich habe viele Fotos gemacht.	I took a lot of pictures.	[sound:Firetongues-DE-EN-0411.mp3]	
Die zeige ich dir gerne.	I'll be happy to show them to you.	[sound:Firetongues-DE-EN-0412.mp3]	
Guck mal!	Have a look!	[sound:Firetongues-DE-EN-0413.mp3]	
Auf diesem Bild siehst du den Marienplatz.	In this picture you see the Marienplatz.	[sound:Firetongues-DE-EN-0414.mp3]	
Gib mir dein Handy!	Give me your cell phone!	[sound:Firetongues-DE-EN-0415.mp3]	
Hier, bitte schön.	Here you are.	[sound:Firetongues-DE-EN-0417.mp3]	
Das sieht schön aus.	That looks nice.	[sound:Firetongues-DE-EN-0418.mp3]	
Ich möchte ein Geschenk haben.	I want to have a gift.	[sound:Firetongues-DE-EN-0419.mp3]	
Du kannst mir etwas mit der Post schicken.	You can send me something by mail.	[sound:Firetongues-DE-EN-0420.mp3]	
Vielleicht schreibe ich dir einen Brief.	Maybe I'll write you a letter.	[sound:Firetongues-DE-EN-0421.mp3]	
Ich kann doch gar nicht lesen.	I can't even read.	[sound:Firetongues-DE-EN-0422.mp3]	
Bald fängt die Schule an.	School is about to start.	[sound:Firetongues-DE-EN-0423.mp3]	
In der Schule lernst du Lesen.	At school you learn to read.	[sound:Firetongues-DE-EN-0424.mp3]	
Wenn du Lesen kannst, kriegst du ein Geschenk von mir.	If you can read, you get a gift from me.	[sound:Firetongues-DE-EN-0425.mp3]	
Dann lerne ich jetzt gleich Lesen.	Then I'll learn to read right now.	[sound:Firetongues-DE-EN-0426.mp3]	
Er hilft ihr.	He helps her.	[sound:Firetongues-DE-EN-0428.mp3]	
Guten Abend.	Good evening.	[sound:Firetongues-DE-EN-0429.mp3]	
Einen Tisch für zwei bitte.	A table for two, please.	[sound:Firetongues-DE-EN-0430.mp3]	
Haben Sie reserviert?	Do you have a reservation? (fr.)	[sound:Firetongues-DE-EN-0431.mp3]	
Leider nicht.	Unfortunately not.	[sound:Firetongues-DE-EN-0432.mp3]	
Warten Sie bitte einen Moment.	Please wait a moment. (fr.)	[sound:Firetongues-DE-EN-0434.mp3]	
Sie haben Glück.	You are lucky. (fr.)	[sound:Firetongues-DE-EN-0435.mp3]	
Einen freien Tisch haben wir noch.	We still have one empty table.	[sound:Firetongues-DE-EN-0436.mp3]	
Folgen Sie mir bitte.	Follow me, please.	[sound:Firetongues-DE-EN-0437.mp3]	
Bitte schön, die Speisekarte.	Here you are, the menu.	[sound:Firetongues-DE-EN-0438.mp3]	
Könnten Sie uns etwas empfehlen?	Could you (fr.) recommend something to us?	[sound:Firetongues-DE-EN-0439.mp3]	
Heute haben wir frischen Fisch.	Today we have fresh fish.	[sound:Firetongues-DE-EN-0440.mp3]	
Ich würde Ihnen den Lachs empfehlen.	I would recommend the salmon to you.	[sound:Firetongues-DE-EN-0441.mp3]	
Ganz schön voll hier.	Quite/pretty busy here.	[sound:Firetongues-DE-EN-0442.mp3]	
Schön, dass noch etwas frei war.	It's nice that something was still available.	[sound:Firetongues-DE-EN-0443.mp3]	
Es wäre ärgerlich, wenn wir jetzt ein anderes Restaurant suchen müssten.	It would be annoying if we had to find another restaurant now.	[sound:Firetongues-DE-EN-0444.mp3]	
Ach, das wäre nicht so schlimm.	Oh, that wouldn't be so bad.	[sound:Firetongues-DE-EN-0445.mp3]	
Wir hätte bestimmt etwas Anderes gefunden.	We would have found something else for sure.	[sound:Firetongues-DE-EN-0446.mp3]	
Dann hätten wir noch einen Spaziergang gemacht.	Then we would have taken another walk.	[sound:Firetongues-DE-EN-0447.mp3]	
Isst du gerne Fisch?	Do you like to eat fish?	[sound:Firetongues-DE-EN-0448.mp3]	
Nicht unbedingt.	Not quite.	[sound:Firetongues-DE-EN-0449.mp3]	
Ich hätte gerne ein Schnitzel mit Pommes.	I'd like a Schnitzel with fries.	[sound:Firetongues-DE-EN-0455.mp3]	
Ich nehme den Lachs mit Salzkartoffeln.	I take the salmon with boiled potatoes.	[sound:Firetongues-DE-EN-0456.mp3]	
Sehr gerne.	My pleasure.	[sound:Firetongues-DE-EN-0459.mp3]	
Schmeckt's?	Does it taste good?	[sound:Firetongues-DE-EN-0464.mp3]	
Ich bin ein bisschen überrascht, dass du kein Bier bestellt hast.	I am a bit surprised that you didn't order a beer.	[sound:Firetongues-DE-EN-0466.mp3]	
Fast hätte ich das gemacht.	I almost did.	[sound:Firetongues-DE-EN-0467.mp3]	
Es ist alles sehr lecker.	It's all very tasty.	[sound:Firetongues-DE-EN-0470.mp3]	
Würden Sie uns noch einmal die Speisekarte bringen?	Would you bring us the menu again? (fr.)	[sound:Firetongues-DE-EN-0473.mp3]	
Haben Sie schon gewählt?	Have you chosen? (fr.)	[sound:Firetongues-DE-EN-0475.mp3]	
Ich hätte gerne ein Stück Schokokuchen.	I'd like a piece of chocolate cake.	[sound:Firetongues-DE-EN-0476.mp3]	
Wir würden gerne zahlen.	We would like to pay.	[sound:Firetongues-DE-EN-0478.mp3]	
Getrennt oder zusammen?	Separately or together?	[sound:Firetongues-DE-EN-0479.mp3]	
Mit Karte oder bar?	With credit card or cash?	[sound:Firetongues-DE-EN-0480.mp3]	
Das macht dann sechsundvierzig Euro.	That's forty six euros then.	[sound:Firetongues-DE-EN-0481.mp3]	
Ich wünsche Ihnen einen schönen Abend.	I wish you a nice evening. (pl.)	[sound:Firetongues-DE-EN-0483.mp3]	
Danke, gleichfalls.	Thanks, you too.	[sound:Firetongues-DE-EN-0484.mp3]	
Ich hätte gerne zwei Kilo Äpfel	I would like two kilos of apples	[sound:Firetongues-DE-EN-0487.mp3]	
Sonst noch etwas?	Anything else?	[sound:Firetongues-DE-EN-0489.mp3]	
Ich bräuchte noch Eier.	I'd also need eggs.	[sound:Firetongues-DE-EN-0490.mp3]	
Acht Stück bitte.	Eight pieces, please.	[sound:Firetongues-DE-EN-0491.mp3]	
War's das?	That's it?	[sound:Firetongues-DE-EN-0492.mp3]	
Vielleicht noch ein paar Kirschen.	Maybe a couple cherries.	[sound:Firetongues-DE-EN-0493.mp3]	
Wie viel kostet das Kilo?	How much does a kilo cost?	[sound:Firetongues-DE-EN-0494.mp3]	
Das sind Bio-Kirschen in Top-Qualität.	These are top quality organic cherries.	[sound:Firetongues-DE-EN-0497.mp3]	
Die sind aber süß!	They're so sweet!	[sound:Firetongues-DE-EN-0499.mp3]	
Ich nehme dreihundert Gramm.	I take three hundred grams.	[sound:Firetongues-DE-EN-0500.mp3]	
Und noch ein halbes Bauernbrot.	And half a farmer's bread.	[sound:Firetongues-DE-EN-0501.mp3]	
Das hätte ich fast vergessen.	I almost forgot.	[sound:Firetongues-DE-EN-0502.mp3]	
Das macht dann neunzehn Euro fünfundsiebzig.	That's nineteen euros seventy five.	[sound:Firetongues-DE-EN-0503.mp3]	
Es war ein schöner Abend letzte Woche.	It was a nice evening last week.	[sound:Firetongues-DE-EN-0504.mp3]	
Auf jeden Fall.	By all means/definitely.	[sound:Firetongues-DE-EN-0508.mp3]	
Hast du Lust am Freitagabend mit mir ins Kino zu gehen?	Would you like to go to the cinema with me Friday night?/<br>Do you feel like going to the cinema with me on Friday night?	[sound:Firetongues-DE-EN-0509.mp3]	
Der neue Film soll gut sein.	The new film is said to be good.	[sound:Firetongues-DE-EN-0510.mp3]	
Lass mich überlegen.	Let me think about it.	[sound:Firetongues-DE-EN-0511.mp3]	
Um wie viel Uhr?	At what time?	[sound:Firetongues-DE-EN-0512.mp3]	
Wie alt bist du?	How old are you?	[sound:Firetongues-DE-EN-0517.mp3]	
tausendfünfhundertzweiunddreißig	one thousand five hundred and thirty two	[sound:Firetongues-DE-EN-0530.mp3]	
Wie viel Uhr ist es?	What time is it?	[sound:Firetongues-DE-EN-0531.mp3]	
Heute ist es echt heiß draußen.	Today it's really hot outside.	[sound:Firetongues-DE-EN-0538.mp3]	
Es ist ziemlich heiß.	It's pretty hot.	[sound:Firetongues-DE-EN-0539.mp3]	
In Madrid ist es oft noch heißer.	In Madrid, it's often even hotter.	[sound:Firetongues-DE-EN-0540.mp3]	
Im Winter ist es mir in Deutschland zu kalt.	In winter, it is too cold for me in Germany.	[sound:Firetongues-DE-EN-0541.mp3]	
Jetzt bin ich froh, dass es in Deutschland kälter als in Spanien ist.	Now, I am glad that it is colder in Germany than in Spain.	[sound:Firetongues-DE-EN-0542.mp3]	
Lebt deine ganze Familie noch dort?	Does your whole family still live there?	[sound:Firetongues-DE-EN-0543.mp3]	
Hast du Geschwister?	Do you have brothers or sisters?	[sound:Firetongues-DE-EN-0544.mp3]	
Meine Eltern sind glücklich, dass ihre Kinder in ihrer Nähe wohnen.	My parents are happy that their children live nearby.	[sound:Firetongues-DE-EN-0545.mp3]	
Sind deine Geschwister älter oder jünger als du?	Are your siblings older or younger than you?	[sound:Firetongues-DE-EN-0548.mp3]	
Ich bin der Jüngste.	I am the youngest.	[sound:Firetongues-DE-EN-0549.mp3]	
Mein Bruder ist zweiunddreißig Jahre alt.	My brother is thirty-two.	[sound:Firetongues-DE-EN-0550.mp3]	
Er ist sieben Jahre älter als ich.	He is seven years older than me.	[sound:Firetongues-DE-EN-0551.mp3]	
Meine Schwester ist die älteste von uns.	My sister is the oldest of us.	[sound:Firetongues-DE-EN-0552.mp3]	
Sie ist dreiunddreißig.	She is thirty-three.	[sound:Firetongues-DE-EN-0553.mp3]	
Leben die beiden in Madrid?	Do they both live in Madrid?	[sound:Firetongues-DE-EN-0554.mp3]	
Meine Oma und mein Opa leben auch dort.	My grandma and my grandpa live there, too.	[sound:Firetongues-DE-EN-0555.mp3]	
Ich bin der einzige, der das Land verlassen hat.	I am the only one who has left the country.	[sound:Firetongues-DE-EN-0556.mp3]	
Ist Madrid eine saubere Stadt?	Is Madrid a clean city?	[sound:Firetongues-DE-EN-0557.mp3]	
Mehr oder weniger.	More or less.	[sound:Firetongues-DE-EN-0558.mp3]	
schmutziger als München	dirtier than Munich	[sound:Firetongues-DE-EN-0559.mp3]	
Ich glaube, Deutschland hat die saubersten Städte auf der Welt.	I think Germany has the cleanest cities in the world.	[sound:Firetongues-DE-EN-0560.mp3]	
Der Hund ist faul.	The dog is lazy.	[sound:Firetongues-DE-EN-0561.mp3]	
Die Katze ist fauler.	The cat is lazier.	[sound:Firetongues-DE-EN-0562.mp3]	
Das Faultier ist am faulsten.	The sloth is most lazy.	[sound:Firetongues-DE-EN-0563.mp3]	
Äpfel schmecken gut.	Apples taste good.	[sound:Firetongues-DE-EN-0564.mp3]	
Bananen schmecken besser.	Bananas taste better.	[sound:Firetongues-DE-EN-0565.mp3]	
Kirschen schmecken am besten.	Cherries taste best.	[sound:Firetongues-DE-EN-0566.mp3]	
Georg schläft viel.	Georg sleeps a lot.	[sound:Firetongues-DE-EN-0567.mp3]	
Seine Schwester schläft mehr.	His sister sleeps more.	[sound:Firetongues-DE-EN-0568.mp3]	
Sein Bruder schläft am meisten.	His brother sleeps most.	[sound:Firetongues-DE-EN-0569.mp3]	
Anna macht gerne Urlaub in den Bergen.	Anna likes to go on vacation in the mountains.	[sound:Firetongues-DE-EN-0570.mp3]	
Sie macht lieber Urlaub am Meer.	She prefers vacation by the sea.	[sound:Firetongues-DE-EN-0571.mp3]	
Sie fährt am liebsten nach Spanien.	She likes going to Spain best.	[sound:Firetongues-DE-EN-0572.mp3]	
Hast du eine bessere Idee?	Do you have a better idea?	[sound:Firetongues-DE-EN-0573.mp3]	
Georg hat einen älteren Bruder.	George has an older brother.	[sound:Firetongues-DE-EN-0574.mp3]	
Was ist das Lustigste, was du je erlebt hast?	What's the funniest thing you've ever experienced?	[sound:Firetongues-DE-EN-0575.mp3]	
Anna freut sich schon auf ihr Date mit Max.	Anna is looking forward to her date with Max.	[sound:Firetongues-DE-EN-0576.mp3]	
Sie hatte einen langen Tag und ist sehr müde.	She had a long day and very tired.	[sound:Firetongues-DE-EN-0577.mp3]	
Sie möchte sich kurz hinlegen, bevor sie sich fertigmacht.	She wants to lie down briefly before getting ready for the date.	[sound:Firetongues-DE-EN-0578.mp3]	
Als Anna wieder aufsteht, schaut sie auf die Uhr.	When Anna gets up again, she looks at the clock.	[sound:Firetongues-DE-EN-0579.mp3]	
Es ist sechs Uhr dreißig.	It is six thirty.	[sound:Firetongues-DE-EN-0580.mp3]	
"Anna sagt sich: ""Beeil dich!"""	"Anna says to herself ""Hurry up!""."	[sound:Firetongues-DE-EN-0581.mp3]	
Du musst dir noch die Haare waschen.	You still have to wash your hair.	[sound:Firetongues-DE-EN-0582.mp3]	
Nachdem sie geduscht hat, zieht sie sich an.	After having taken, a shower she gets dressed.	[sound:Firetongues-DE-EN-0583.mp3]	
Sie setzt sich, um sich zu schminken.	She sits down to put on her make-up.	[sound:Firetongues-DE-EN-0584.mp3]	
Als sie fertig ist, läuft sie so schnell wie möglich zur Straßenbahn.	When she's done, she runs to the tram as fast as possible.	[sound:Firetongues-DE-EN-0585.mp3]	
Um acht Uhr kommt sie an der Uni an.	At eight o'clock she arrives at the university.	[sound:Firetongues-DE-EN-0586.mp3]	
Max wartet schon auf sie.	Max is already waiting for her.	[sound:Firetongues-DE-EN-0587.mp3]	
Sie entschuldigt sich.	She apologizes.	[sound:Firetongues-DE-EN-0588.mp3]	
Tut mir echt leid, dass ich so spät bin.	I'm really sorry I'm so late.	[sound:Firetongues-DE-EN-0589.mp3]	
Ich habe verschlafen.	I've overslept.	[sound:Firetongues-DE-EN-0590.mp3]	
Max regt sich nicht auf.	Max doesn't get upset.	[sound:Firetongues-DE-EN-0591.mp3]	
Entspann dich!	Relax!	[sound:Firetongues-DE-EN-0592.mp3]	
Schön, dass du da bist.	It’s nice that you're here.	[sound:Firetongues-DE-EN-0593.mp3]	
Im Kino kommt sowieso immer Werbung vor den Filmen.	In the cinema, there’s always advertising before the movies anyway.	[sound:Firetongues-DE-EN-0594.mp3]	
Wenn wir uns beeilen, kommen wir rechtzeitig an.	If we hurry, we'll arrive on time.	[sound:Firetongues-DE-EN-0595.mp3]	
Gehen wir!	Let's go!	[sound:Firetongues-DE-EN-0596.mp3]	
Ich möchte mir gerne einen Opel kaufen. Doch kann ich mir das leisten?	I would like to buy an Opel. But I can afford that?	[sound:Firetongues-DE-EN-0597.mp3]	
Wir machen uns Sorgen, weil unsere Tochter Motorrad fährt.	We are worried because our daughter rides a motorbike.	[sound:Firetongues-DE-EN-0598.mp3]	
Das ist gefährlich. Sie könnte sich verletzen.	That's dangerous. She could get hurt.	[sound:Firetongues-DE-EN-0599.mp3]	
Sieh dir das mal an!	Have a look at this!	[sound:Firetongues-DE-EN-0600.mp3]	
Du wünschst dir neue Schuhe zum Geburtstag.	You want new shoes for your birthday.	[sound:Firetongues-DE-EN-0601.mp3]	
Bitte melde dich!	Please contact me! (lit. “Please report yourself!”)	[sound:Firetongues-DE-EN-0602.mp3]	
Erinnerst du dich noch an mich?	Do you remember me?	[sound:Firetongues-DE-EN-0603.mp3]	
In einer guten Beziehung muss man sich nicht oft streiten.	You don't have to argue often in a good relationship.	[sound:Firetongues-DE-EN-0604.mp3]	
Sie kennen sich schon lange.	They have known each other a long time.	[sound:Firetongues-DE-EN-0605.mp3]	
Sie treffen sich jede Woche.	They meet every week.	[sound:Firetongues-DE-EN-0606.mp3]	
Du gibst dir Mühe.	You are making an effort.	[sound:Firetongues-DE-EN-0609.mp3]	
Anna geht heim.	Anna goes home.	[sound:Firetongues-DE-EN-0610.mp3]	
Sie kommt zu Hause an.	She arrives at home.	[sound:Firetongues-DE-EN-0611.mp3]	
Sie nimmt ihren Schlüssel.	She takes her key.	[sound:Firetongues-DE-EN-0612.mp3]	
Sie macht die Tür auf.	She opens the door.	[sound:Firetongues-DE-EN-0613.mp3]	
Sie geht hinein.	She goes inside.	[sound:Firetongues-DE-EN-0614.mp3]	
Sie macht die Tür zu.	She closes the door.	[sound:Firetongues-DE-EN-0615.mp3]	
Dann macht sie das Licht an.	Then she turns on the light.	[sound:Firetongues-DE-EN-0616.mp3]	
Sie macht sich für die Nacht fertig.	She gets ready for the night.	[sound:Firetongues-DE-EN-0617.mp3]	
Sie macht das Licht aus und legt sich ins Bett.	She turns off the light and goes to bed.	[sound:Firetongues-DE-EN-0618.mp3]	
Sie kann nicht einschlafen.	She cannot fall asleep.	[sound:Firetongues-DE-EN-0619.mp3]	
Sie denkt an Max.	She thinks of Max.	[sound:Firetongues-DE-EN-0620.mp3]	
Er hat sie geküsst.	He kissed her.	[sound:Firetongues-DE-EN-0621.mp3]	
Es war ihr erster Kuss.	It was her first kiss.	[sound:Firetongues-DE-EN-0622.mp3]	
Es hat sich komisch angefühlt	It felt weird.	[sound:Firetongues-DE-EN-0623.mp3]	
Passen sie überhaupt zusammen?	Are they even a good match?	[sound:Firetongues-DE-EN-0624.mp3]	
Anna findet, dass sie vielleicht etwas zu ernst für Max ist.	Anna thinks that she might be a little too serious for Max.	[sound:Firetongues-DE-EN-0625.mp3]	
Um ein Uhr nachts ist Anna noch immer nicht eingeschlafen.	Anna still has not fallen asleep at one in the morning.	[sound:Firetongues-DE-EN-0626.mp3]	
Am nächsten Morgen steht sie um sieben Uhr auf.	The next morning, she gets up at seven o'clock.	[sound:Firetongues-DE-EN-0627.mp3]	
Sie ist todmüde.	She's dead tired.	[sound:Firetongues-DE-EN-0628.mp3]	
Um acht Uhr fängt die Uni an.	At eight o'clock, university starts.	[sound:Firetongues-DE-EN-0629.mp3]	
Warum sind die beiden nicht am Wochenende ins Kino gegangen?	Why didn't the two of them go to the movies at the weekend?	[sound:Firetongues-DE-EN-0630.mp3]	
Sie hasst es, früh aufzustehen.	She hates getting up early.	[sound:Firetongues-DE-EN-0638.mp3]	
Ich habe mich entschieden, dich anzurufen.	I decided to call you.	[sound:Firetongues-DE-EN-0639.mp3]	
Wird es morgen regnen?	Will it rain tomorrow?	[sound:Firetongues-DE-EN-0640.mp3]	
Wir werden sehen.	We will see.	[sound:Firetongues-DE-EN-0641.mp3]	
Das wirst du noch bereuen.	You'll regret that.	[sound:Firetongues-DE-EN-0642.mp3]	
Werden Max und Anna heiraten?	Will Max and Anna get married?	[sound:Firetongues-DE-EN-0643.mp3]	
Das wird schon gehen.	That'll be all right.	[sound:Firetongues-DE-EN-0644.mp3]	
Es wird schon nichts passieren.	Nothing will happen.	[sound:Firetongues-DE-EN-0645.mp3]	
Wenn du das sagst, wird das wohl stimmen.	If you say that, it's probably true.	[sound:Firetongues-DE-EN-0646.mp3]	
Max ist Annas Freund.	Max is Anna's friend.	[sound:Firetongues-DE-EN-0647.mp3]	
Was ist die beste Lösung des Problems?	What is the best solution to the problem?	[sound:Firetongues-DE-EN-0648.mp3]	
Das Gesicht der Frau ist eher hässlich.	The woman's face is rather ugly.	[sound:Firetongues-DE-EN-0649.mp3]	
Der Bruder des Mannes ist arm.	The man's brother is poor.	[sound:Firetongues-DE-EN-0650.mp3]	
Der Vater der jungen Frau ist reich.	The young woman's father is rich.	[sound:Firetongues-DE-EN-0651.mp3]	
Wem gehört dieses Zeug?	To whom does this stuff below?	[sound:Firetongues-DE-EN-0652.mp3]	
Das sind die Sachen einer Freundin.	These are the things of a friend.	[sound:Firetongues-DE-EN-0653.mp3]	
Wegen der lauten Musik tun mir die Ohren weh.	Because of the loud music my ears hurt.	[sound:Firetongues-DE-EN-0654.mp3]	
Die Freundin meiner Mutter ist im Krankenhaus.	My mother's friend is in the hospital.	[sound:Firetongues-DE-EN-0655.mp3]	
Das Problem der jungen Leute ist, dass sie keinen Bock haben, sich anzustrengen.	The problem of young people is that they don't feel like making an effort.	[sound:Firetongues-DE-EN-0656.mp3]	
Das war die wichtigste Erfahrung meines Lebens.	That was the most important experience of my life.	[sound:Firetongues-DE-EN-0657.mp3]	
Nazi-Deutschland ist der dunkelste Teil der deutschen Geschichte.	Nazi Germany is the darkest part of German history.	[sound:Firetongues-DE-EN-0658.mp3]	
Während meiner Reise habe ich viele schöne Orte kennengelernt.	During my trip, I got to know many beautiful places.	[sound:Firetongues-DE-EN-0659.mp3]	
Eines Tages müssen wir alle sterben.	One day we all must die.	[sound:Firetongues-DE-EN-0660.mp3]	
Plötzlich macht alles Sinn.	Suddenly, it all makes sense.	[sound:Firetongues-DE-EN-0665.mp3]	
Du findest immer irgendeinen Grund, andere für dich arbeiten zu lassen.	You always find some reason to let others work for you.	[sound:Firetongues-DE-EN-0666.mp3]	
Zwischen mir und den Nachbarn gibt es immer Probleme.	There are always problems between me and my neighbors.	[sound:Firetongues-DE-EN-0667.mp3]	
Niemand hat sich getraut, seine Meinung zu sagen.	Nobody dared to speak his mind.	[sound:Firetongues-DE-EN-0668.mp3]	
Rate mal, was ich bekommen habe: Ein Fahrrad.	Guess what I got: A bicycle.	[sound:Firetongues-DE-EN-0669.mp3]	
Ich frage mich, ob ich es schaffen kann.	I wonder if I can do it.	[sound:Firetongues-DE-EN-0670.mp3]	
Bist du bereit?	Are you ready?	[sound:Firetongues-DE-EN-0671.mp3]	
Möchte jemand etwas unternehmen?	Does anyone want to do something?	[sound:Firetongues-DE-EN-0672.mp3]	
Das Frühstück ist gratis.	The breakfast is free.	[sound:Firetongues-DE-EN-0673.mp3]	
Bald ist alles vorbei.	Everything will be over soon.	[sound:Firetongues-DE-EN-0674.mp3]	
Der Kuchen wird gegessen.	The cake is eaten.	[sound:Firetongues-DE-EN-0675.mp3]	
Du wirst geliebt, ich werde gehasst.	You are loved, I am hated.	[sound:Firetongues-DE-EN-0676.mp3]	
Die Prüfung wird verschoben.	The test is postponed.	[sound:Firetongues-DE-EN-0677.mp3]	
Die Unterschiede wurden deutlich gemacht.	The differences were made clear.	[sound:Firetongues-DE-EN-0678.mp3]	
Das Programm wurde geändert.	The program was changed.	[sound:Firetongues-DE-EN-0679.mp3]	
Das muss gemacht werden.	This must be done.	[sound:Firetongues-DE-EN-0680.mp3]	
Das neue Thema wird den Schülern von ihrem Lehrer erklärt.	The new topic is explained to the students by their teacher.	[sound:Firetongues-DE-EN-0681.mp3]	
Du wurdest von ihm gesehen.	You were seen by him.	[sound:Firetongues-DE-EN-0682.mp3]	
Er wurde durch ein Wunder gerettet.	He was saved by a miracle.	[sound:Firetongues-DE-EN-0683.mp3]	
Es wurde ein Fehler gemacht.	A mistake has been made.	[sound:Firetongues-DE-EN-0684.mp3]	
Es wird dir geholfen.	You get help.	[sound:Firetongues-DE-EN-0685.mp3]	
Jetzt wird nicht geredet!	No one is talking now!	[sound:Firetongues-DE-EN-0686.mp3]	
Herzlichen Glückwunsch!	Congratulations!	[sound:Firetongues-DE-EN-0687.mp3]	
Du hast unseren Deutschkurs erfolgreich abgeschlossen.	You've successfully completed our German course.	[sound:Firetongues-DE-EN-0688.mp3]	
Wie denkst du, dass die Geschichte von Max und Anna ausgeht?	How do you think the story of Max and Anna ends?	[sound:Firetongues-DE-EN-0689.mp3]	
Du darfst dir gerne selbst etwas überlegen.	You may think of something yourself.	[sound:Firetongues-DE-EN-0690.mp3]	
Hör bloß nicht auf, Deutsch zu lernen!	Now don't stop learning German.	[sound:Firetongues-DE-EN-0691.mp3]	
Du kennst jetzt circa 1000 Wörter.	You now know about 1000 words.	[sound:Firetongues-DE-EN-0692.mp3]	
Jetzt kannst du Filme oder Serien auf Deutsch sehen.	Now you can watch movies or series in German.	[sound:Firetongues-DE-EN-0694.mp3]	
Du kannst Deutsch sprechen und mit Deutschsprechern kommunizieren.	You can speak German and communicate with German speakers.	[sound:Firetongues-DE-EN-0696.mp3]	
Du kannst stolz auf dich sein.	You can be proud of yourself.	[sound:Firetongues-DE-EN-0697.mp3]	
Lies hier, wie du am besten weitermachen kannst.	Read here how you can best continue.	[sound:Firetongues-DE-EN-0698.mp3]	
Weiterhin viel Erfolg!	May your success continue!	[sound:Firetongues-DE-EN-0700.mp3]	